PPPPPPPPP
PPPPHPPPP
PBPPBPPPB
PPTTPPPPP
PPTTPPPPP
HHHHHHHHH
